25 20
#############            
#...........#    ########
#...s...s...######......#
#....................i..#
#...........######......#
#.....s.....#    #......#
#...........#    #......#
#...........#    #......#
#####..######    ###..###
    #..#           #..#  
    #..#           #..#  
    #i.#         ###..###
  ###..####      #......#
  #..p....#      #...i..#
  #.......#      #......#
  #.......#      #......#
  #.......#      #......#
  #.......#      #......#
  #.......#      #......#
  #########      ########